11111111111111
10010000E00001
10000111110001
100011000P0001
10001100002001
10001111000001
11111111111111
