11111111111111
1C010000000C01
10000111110001
1P0011E00000C1
10001100000001
10001111000001
11111111111111
