11111111111111
1C01000E000C01
10000111110001
100011000000C1
100011000P0001
10001111000001
11111111111111
